--*F*---
---*----
-****---
---****-
---*--*-
------S-