--S-----
--***---
-**-*---
-*--*---
-*--**--
-----*--
--****--
--*-----
--**F---